a	a
á	a'
à	a`
ã	a~
ả	a?
ạ	a.

â	a^
ấ	a^'
ầ	a^`
ẫ	a^~
ẩ	a^?
ậ	a^.

ă	a(
ắ	a('
ằ	a(`
ẵ	a(~
ẳ	a(?
ặ	a(.

b	b

c	c

d	d

đ	dd

e	e
é	e'
è	e`
ẽ	e~
ẻ	e?
ẹ	e.

ê	e^
ế	e^'
ề	e^`
ễ	e^~
ể	e^?
ệ	e^.

f	f

g	g

h	h

i	i
í	i'
ì	i`
ĩ	i~
ỉ	i?
ị	i.

j	j

k	k

l	l

m	m

n	n

o	o
ó	o'
ò	o`
õ	o~
ỏ	o?
ọ	o.

ô	o^
ố	o^'
ồ	o^`
ỗ	o^~
ổ	o^?
ộ	o^.

ơ	o+
ớ	o+'
ờ	o+`
ỡ	o+~
ở	o+?
ợ	o+.

p	p

q	q

r	r

s	s

t	t

u	u
ú	u'
ù	u`
ũ	u~
ủ	u?
ụ	u.

ư	u+
ứ	u+'
ừ	u+`
ữ	u+~
ử	u+?
ự	u+.

v	v

w	w

x	x

y	y
ý	y'
ỳ	y`
ỹ	y~
ỷ	y?
ỵ	y.

z	z